-906		78		-1055		0		0			1			0			42			50			2				105				150			6				7			1
-906		155		-1130		0		0			1			0			42			2			50				105				6			150				7			1
-970		78		-1130		0		0			1			0			2			50			50				6				150			150				7			1
-941		80		-1200		0		0			1			0			21			50			2				75				150			6				7			1
-851		78		-1130		0		0			1			0			2			50			50				6				150			150				7			1
-856		15		-1200		0		0			1			0			5			50			2				15				150			6				7			1
-886		130		-1200		0		0			1			0			15			15			2				45				45			6				7			1
-886		75		-1200		0		0			1			0			10			8			15				30				24			45				14			1
-931		60		-1100		0		0			1			0			5			5			5				15				15			15				18			1

-906		78		-815		0		0			1			0			42			50			2				105				150			6				7			1
-906		155		-890		0		0			1			0			42			2			50				105				6			150				7			1
-970		78		-890		0		0			1			0			2			50			50				6				150			150				7			1
-941		80		-960		0		0			1			0			21			50			2				75				150			6				7			1
-851		78		-890		0		0			1			0			2			50			50				6				150			150				7			1
-856		15		-960		0		0			1			0			5			50			2				15				150			6				7			1
-886		130		-960		0		0			1			0			15			15			2				45				45			6				7			1
-886		75		-960		0		0			1			0			10			8			15				30				24			45				14			1
-931		60		-860		0		0			1			0			5			5			5				15				15			15				18			1

-906		78		-575		0		0			1			0			42			50			2				105				150			6				7			1
-906		155		-650		0		0			1			0			42			2			50				105				6			150				7			1
-970		78		-650		0		0			1			0			2			50			50				6				150			150				7			1
-941		80		-720		0		0			1			0			21			50			2				75				150			6				7			1
-851		78		-650		0		0			1			0			2			50			50				6				150			150				7			1
-856		15		-720		0		0			1			0			5			50			2				15				150			6				7			1
-886		130		-720		0		0			1			0			15			15			2				45				45			6				7			1
-886		75		-720		0		0			1			0			10			8			15				30				24			45				14			1
-931		60		-620		0		0			1			0			5			5			5				15				15			15				18			1

-906		78		-335		0		0			1			0			42			50			2				105				150			6				7			1
-906		155		-410		0		0			1			0			42			2			50				105				6			150				7			1
-970		78		-410		0		0			1			0			2			50			50				6				150			150				7			1
-941		80		-480		0		0			1			0			21			50			2				75				150			6				7			1
-851		78		-410		0		0			1			0			2			50			50				6				150			150				7			1
-856		70		-480		0		0			1			0			5			50			2				15				150			6				7			1
-886		120		-480		0		0			1			0			15			15			2				45				45			6				7			1
-886		65		-480		0		0			1			0			10			8			15				30				24			45				14			1
-931		80		-380		0		0			1			0			5			5			5				15				15			15				18			1

-650		78		-95			0		0			1			0			42			50			2				105				150			6				7			1
-650		155		-170		0		0			1			0			42			2			50				105				6			150				7			1
-714		78		-170		0		0			1			0			2			50			50				6				150			150				7			1
-685		80		-240		0		0			1			0			21			50			2				75				150			6				7			1
-595		78		-170		0		0			1			0			2			50			50				6				150			150				7			1
-600		75		-240		0		0			1			0			5			50			2				15				150			6				7			1
-630		130		-240		0		0			1			0			15			15			2				45				45			6				7			1
-630		75		-240		0		0			1			0			10			8			15				30				24			45				14			1
-675		60		-140		0		0			1			0			5			5			5				15				15			15				18			1

-450		68		-95			0		0			1			0			42			50			2				105				150			6				7			1
-450		145		-170		0		0			1			0			42			2			50				105				6			150				7			1
-514		68		-170		0		0			1			0			2			50			50				6				150			150				7			1
-485		70		-240		0		0			1			0			21			50			2				75				150			6				7			1
-395		68		-170		0		0			1			0			2			50			50				6				150			150				7			1
-400		75		-240		0		0			1			0			5			50			2				15				150			6				7			1
-430		120		-240		0		0			1			0			15			15			2				45				45			6				7			1
-430		65		-240		0		0			1			0			10			8			15				30				24			45				14			1
-475		50		-140		0		0			1			0			5			5			5				15				15			15				18			1

-250		78		-95			0		0			1			0			42			50			2				105				150			6				7			1
-250		155		-170		0		0			1			0			42			2			50				105				6			150				7			1
-314		78		-170		0		0			1			0			2			50			50				6				150			150				7			1
-285		80		-240		0		0			1			0			21			50			2				75				150			6				7			1
-195		78		-170		0		0			1			0			2			50			50				6				150			150				7			1
-200		85		-240		0		0			1			0			5			50			2				15				150			6				7			1
-230		130		-240		0		0			1			0			15			15			2				45				45			6				7			1
-230		75		-240		0		0			1			0			10			8			15				30				24			45				14			1
-275		60		-140		0		0			1			0			5			5			5				15				15			15				18			1

-650		68		-1335		0		0			1			0			42			50			2				105				150			6				7			1
-650		145		-1410		0		0			1			0			42			2			50				105				6			150				7			1
-714		68		-1410		0		0			1			0			2			50			50				6				150			150				7			1
-685		70		-1480		0		0			1			0			21			50			2				75				150			6				7			1
-595		68		-1410		0		0			1			0			2			50			50				6				150			150				7			1
-600		65		-1480		0		0			1			0			5			50			2				15				150			6				7			1
-630		120		-1480		0		0			1			0			15			15			2				45				45			6				7			1
-630		65		-1480		0		0			1			0			10			8			15				30				24			45				14			1
-675		50		-1380		0		0			1			0			5			5			5				15				15			15				18			1

-450		68		-1335		0		0			1			0			42			50			2				105				150			6				7			1
-450		145		-1410		0		0			1			0			42			2			50				105				6			150				7			1
-514		68		-1410		0		0			1			0			2			50			50				6				150			150				7			1
-485		70		-1480		0		0			1			0			21			50			2				75				150			6				7			1
-395		68		-1410		0		0			1			0			2			50			50				6				150			150				7			1
-400		65		-1480		0		0			1			0			5			50			2				15				150			6				7			1
-430		120		-1480		0		0			1			0			15			15			2				45				45			6				7			1
-430		65		-1480		0		0			1			0			10			8			15				30				24			45				14			1
-475		50		-1380		0		0			1			0			5			5			5				15				15			15				18			1

-250		68		-1335		0		0			1			0			42			50			2				105				150			6				7			1
-250		145		-1410		0		0			1			0			42			2			50				105				6			150				7			1
-314		68		-1410		0		0			1			0			2			50			50				6				150			150				7			1
-285		70		-1480		0		0			1			0			21			50			2				75				150			6				7			1
-195		68		-1410		0		0			1			0			2			50			50				6				150			150				7			1
-200		65		-1480		0		0			1			0			5			50			2				15				150			6				7			1
-230		120		-1480		0		0			1			0			15			15			2				45				45			6				7			1
-230		65		-1480		0		0			1			0			10			8			15				30				24			45				14			1
-275		50		-1380		0		0			1			0			5			5			5				15				15			15				18			1

-250		68		-335		0		0			1			0			42			50			2				105				150			6				7			1
-250		145		-410		0		0			1			0			42			2			50				105				6			150				7			1
-314		68		-410		0		0			1			0			2			50			50				6				150			150				7			1
-285		70		-480		0		0			1			0			21			50			2				75				150			6				7			1
-195		68		-410		0		0			1			0			2			50			50				6				150			150				7			1
-200		65		-480		0		0			1			0			5			50			2				15				150			6				7			1
-230		120		-480		0		0			1			0			15			15			2				45				45			6				7			1
-230		65		-480		0		0			1			0			10			8			15				30				24			45				14			1
-275		50		-380		0		0			1			0			5			5			5				15				15			15				18			1

-50		68		-575		0		0			1			0			42			50			2				105				150			6				7			1
-50		145		-650		0		0			1			0			42			2			50				105				6			150				7			1
-114	68		-650		0		0			1			0			2			50			50				6				150			150				7			1
-85		70		-720		0		0			1			0			21			50			2				75				150			6				7			1
5		68		-650		0		0			1			0			2			50			50				6				150			150				7			1
0		65		-720		0		0			1			0			5			50			2				15				150			6				7			1
-30		120		-720		0		0			1			0			15			15			2				45				45			6				7			1
-30		65		-720		0		0			1			0			10			8			15				30				24			45				14			1
-75		50		-620		0		0			1			0			5			5			5				15				15			15				18			1

-250		68		-575		0		0			1			0			42			50			2				105				150			6				7			1
-250		145		-650		0		0			1			0			42			2			50				105				6			150				7			1
-314		68		-650		0		0			1			0			2			50			50				6				150			150				7			1
-285		70		-720		0		0			1			0			21			50			2				75				150			6				7			1
-195		68		-650		0		0			1			0			2			50			50				6				150			150				7			1
-200		65		-720		0		0			1			0			5			50			2				15				150			6				7			1
-230		120		-720		0		0			1			0			15			15			2				45				45			6				7			1
-230		65		-720		0		0			1			0			10			8			15				30				24			45				14			1
-275		50		-620		0		0			1			0			5			5			5				15				15			15				18			1

-450		68		-575		0		0			1			0			42			50			2				105				150			6				7			1
-450		145		-650		0		0			1			0			42			2			50				105				6			150				7			1
-514		68		-650		0		0			1			0			2			50			50				6				150			150				7			1
-485		70		-720		0		0			1			0			21			50			2				75				150			6				7			1
-395		68		-650		0		0			1			0			2			50			50				6				150			150				7			1
-400		65		-720		0		0			1			0			5			50			2				15				150			6				7			1
-430		120		-720		0		0			1			0			15			15			2				45				45			6				7			1
-430		65		-720		0		0			1			0			10			8			15				30				24			45				14			1
-475		50		-620		0		0			1			0			5			5			5				15				15			15				18			1

-700		78		-1700		0		0			1			0			600			50			5				1200			150			30			7			1
-700		78		380			0		0			1			0			600			50			5				1200			150			30				7			1
-1300		78		-615		0		0			1			0			8			50			800				30				150			2000			7			1
200			78		0			0		0			1			0			8			50			250				30				150			500				7			1
200			78		-615		0		0			1			0			8			50			145				30				150			290				7			1
195			120		-388		0		0			1			0			2			22			10				30				22			20				7			1
195			120		-843		0		0			1			0			2			22			10				30				22			20				7			1
200			78		-1070		0		0			1			0			8			50			145				30				150			290				7			1
200			78		-1500		0		0			1			0			8			50			142				30				150			284				7			1

394		78		-1055		0		0			1			0			42			50			2				105				150			6				7			1
394		155		-1130		0		0			1			0			42			2			50				105				6			150				7			1
330		78		-1130		0		0			1			0			2			50			50				6				150			150				7			1
359		80		-1200		0		0			1			0			21			50			2				75				150			6				7			1
449		78		-1130		0		0			1			0			2			50			50				6				150			150				7			1
444		55		-1200		0		0			1			0			5			50			2				15				150			6				7			1
414		130		-1200		0		0			1			0			15			15			2				45				45			6				7			1
414		70		-1200		0		0			1			0			10			8			15				30				24			45				14			1
369		60		-1100		0		0			1			0			5			5			5				15				15			15				18			1

394		78		-815		0		0			1			0			42			50			2				105				150			6				7			1
394		155		-890		0		0			1			0			42			2			50				105				6			150				7			1
330		78		-890		0		0			1			0			2			50			50				6				150			150				7			1
359		80		-960		0		0			1			0			21			50			2				75				150			6				7			1
449		78		-890		0		0			1			0			2			50			50				6				150			150				7			1
444		15		-960		0		0			1			0			5			50			2				15				150			6				7			1
414		130		-960		0		0			1			0			15			15			2				45				45			6				7			1
414		75		-960		0		0			1			0			10			8			15				30				24			45				14			1
369		60		-860		0		0			1			0			5			5			5				15				15			15				18			1

394		78		-575		0		0			1			0			42			50			2				105				150			6				7			1
394		155		-650		0		0			1			0			42			2			50				105				6			150				7			1
330		78		-650		0		0			1			0			2			50			50				6				150			150				7			1
359		80		-720		0		0			1			0			21			50			2				75				150			6				7			1
449		78		-650		0		0			1			0			2			50			50				6				150			150				7			1
444		15		-720		0		0			1			0			5			50			2				15				150			6				7			1
414		130		-720		0		0			1			0			15			15			2				45				45			6				7			1
414		75		-720		0		0			1			0			10			8			15				30				24			45				14			1
369		60		-620		0		0			1			0			5			5			5				15				15			15				18			1

394		78		-335		0		0			1			0			42			50			2				105				150			6				7			1
394		155		-410		0		0			1			0			42			2			50				105				6			150				7			1
330		78		-410		0		0			1			0			2			50			50				6				150			150				7			1
359		80		-480		0		0			1			0			21			50			2				75				150			6				7			1
449		78		-410		0		0			1			0			2			50			50				6				150			150				7			1
444		70		-480		0		0			1			0			5			50			2				15				150			6				7			1
414		120		-480		0		0			1			0			15			15			2				45				45			6				7			1
414		65		-480		0		0			1			0			10			8			15				30				24			45				14			1
369		80		-380		0		0			1			0			5			5			5				15				15			15				18			1

794		78		-1055		0		0			1			0			42			50			2				105				150			6				7			1
794		155		-1130		0		0			1			0			42			2			50				105				6			150				7			1
730		78		-1130		0		0			1			0			2			50			50				6				150			150				7			1
759		80		-1200		0		0			1			0			21			50			2				75				150			6				7			1
849		78		-1130		0		0			1			0			2			50			50				6				150			150				7			1
844		55		-1200		0		0			1			0			5			50			2				15				150			6				7			1
814		130		-1200		0		0			1			0			15			15			2				45				45			6				7			1
814		70		-1200		0		0			1			0			10			8			15				30				24			45				14			1
769		60		-1100		0		0			1			0			5			5			5				15				15			15				18			1

794		78		-815		0		0			1			0			42			50			2				105				150			6				7			1
794		155		-890		0		0			1			0			42			2			50				105				6			150				7			1
730		78		-890		0		0			1			0			2			50			50				6				150			150				7			1
759		80		-960		0		0			1			0			21			50			2				75				150			6				7			1
849		78		-890		0		0			1			0			2			50			50				6				150			150				7			1
844		15		-960		0		0			1			0			5			50			2				15				150			6				7			1
814		130		-960		0		0			1			0			15			15			2				45				45			6				7			1
814		75		-960		0		0			1			0			10			8			15				30				24			45				14			1
769		60		-860		0		0			1			0			5			5			5				15				15			15				18			1

794		78		-575		0		0			1			0			42			50			2				105				150			6				7			1
794		155		-650		0		0			1			0			42			2			50				105				6			150				7			1
730		78		-650		0		0			1			0			2			50			50				6				150			150				7			1
759		80		-720		0		0			1			0			21			50			2				75				150			6				7			1
849		78		-650		0		0			1			0			2			50			50				6				150			150				7			1
844		15		-720		0		0			1			0			5			50			2				15				150			6				7			1
814		130		-720		0		0			1			0			15			15			2				45				45			6				7			1
814		75		-720		0		0			1			0			10			8			15				30				24			45				14			1
769		60		-620		0		0			1			0			5			5			5				15				15			15				18			1

794		78		-335		0		0			1			0			42			50			2				105				150			6				7			1
794		155		-410		0		0			1			0			42			2			50				105				6			150				7			1
730		78		-410		0		0			1			0			2			50			50				6				150			150				7			1
759		80		-480		0		0			1			0			21			50			2				75				150			6				7			1
849		78		-410		0		0			1			0			2			50			50				6				150			150				7			1
844		70		-480		0		0			1			0			5			50			2				15				150			6				7			1
814		120		-480		0		0			1			0			15			15			2				45				45			6				7			1
814		65		-480		0		0			1			0			10			8			15				30				24			45				14			1
769		80		-380		0		0			1			0			5			5			5				15				15			15				18			1

674		78		-1295		0		0			1			0			42			50			2				105				150			6				7			1
674		155		-1370		0		0			1			0			42			2			50				105				6			150				7			1
610		78		-1370		0		0			1			0			2			50			50				6				150			150				7			1
639		80		-1440		0		0			1			0			21			50			2				75				150			6				7			1
729		78		-1370		0		0			1			0			2			50			50				6				150			150				7			1
724		55		-1440		0		0			1			0			5			50			2				15				150			6				7			1
694		130		-1440		0		0			1			0			15			15			2				45				45			6				7			1
694		70		-1440		0		0			1			0			10			8			15				30				24			45				14			1
649		60		-1340		0		0			1			0			5			5			5				15				15			15				18			1

634		78		-95			0		0			1			0			42			50			2				105				150			6				7			1
634		155		-170		0		0			1			0			42			2			50				105				6			150				7			1
570		78		-170		0		0			1			0			2			50			50				6				150			150				7			1
599		80		-240		0		0			1			0			21			50			2				75				150			6				7			1
689		78		-170		0		0			1			0			2			50			50				6				150			150				7			1
684		70		-240		0		0			1			0			5			50			2				15				150			6				7			1
654		120		-240		0		0			1			0			15			15			2				45				45			6				7			1
654		65		-240		0		0			1			0			10			8			15				30				24			45				14			1
609		80		-140		0		0			1			0			5			5			5				15				15			15				18			1

1174		78		-1295		0		0			1			0			42			50			2				105				150			6				7			1
1174		155		-1370		0		0			1			0			42			2			50				105				6			150				7			1
1110		78		-1370		0		0			1			0			2			50			50				6				150			150				7			1
1139		80		-1440		0		0			1			0			21			50			2				75				150			6				7			1
1229		78		-1370		0		0			1			0			2			50			50				6				150			150				7			1
1224		55		-1440		0		0			1			0			5			50			2				15				150			6				7			1
1194		130		-1440		0		0			1			0			15			15			2				45				45			6				7			1
1194		70		-1440		0		0			1			0			10			8			15				30				24			45				14			1
1149		60		-1340		0		0			1			0			5			5			5				15				15			15				18			1

1374		78		-1295		0		0			1			0			42			50			2				105				150			6				7			1
1374		155		-1370		0		0			1			0			42			2			50				105				6			150				7			1
1310		78		-1370		0		0			1			0			2			50			50				6				150			150				7			1
1339		80		-1440		0		0			1			0			21			50			2				75				150			6				7			1
1429		78		-1370		0		0			1			0			2			50			50				6				150			150				7			1
1424		55		-1440		0		0			1			0			5			50			2				15				150			6				7			1
1394		130		-1440		0		0			1			0			15			15			2				45				45			6				7			1
1394		70		-1440		0		0			1			0			10			8			15				30				24			45				14			1
1349		60		-1340		0		0			1			0			5			5			5				15				15			15				18			1

1574		78		-1295		0		0			1			0			42			50			2				105				150			6				7			1
1574		155		-1370		0		0			1			0			42			2			50				105				6			150				7			1
1510		78		-1370		0		0			1			0			2			50			50				6				150			150				7			1
1539		80		-1440		0		0			1			0			21			50			2				75				150			6				7			1
1629		78		-1370		0		0			1			0			2			50			50				6				150			150				7			1
1624		55		-1440		0		0			1			0			5			50			2				15				150			6				7			1
1594		130		-1440		0		0			1			0			15			15			2				45				45			6				7			1
1594		70		-1440		0		0			1			0			10			8			15				30				24			45				14			1
1549		60		-1340		0		0			1			0			5			5			5				15				15			15				18			1

1374		78		-815		0		0			1			0			42			50			2				105				150			6				7			1
1374		155		-890		0		0			1			0			42			2			50				105				6			150				7			1
1310		78		-890		0		0			1			0			2			50			50				6				150			150				7			1
1339		80		-960		0		0			1			0			21			50			2				75				150			6				7			1
1429		78		-890		0		0			1			0			2			50			50				6				150			150				7			1
1424		55		-960		0		0			1			0			5			50			2				15				150			6				7			1
1394		130		-960		0		0			1			0			15			15			2				45				45			6				7			1
1394		70		-960		0		0			1			0			10			8			15				30				24			45				14			1
1349		60		-860		0		0			1			0			5			5			5				15				15			15				18			1

1374		78		-575		0		0			1			0			42			50			2				105				150			6				7			1
1374		155		-650		0		0			1			0			42			2			50				105				6			150				7			1
1310		78		-650		0		0			1			0			2			50			50				6				150			150				7			1
1339		80		-720		0		0			1			0			21			50			2				75				150			6				7			1
1429		78		-650		0		0			1			0			2			50			50				6				150			150				7			1
1424		55		-720		0		0			1			0			5			50			2				15				150			6				7			1
1394		130		-720		0		0			1			0			15			15			2				45				45			6				7			1
1394		70		-720		0		0			1			0			10			8			15				30				24			45				14			1
1349		60		-620		0		0			1			0			5			5			5				15				15			15				18			1

1374		78		-335		0		0			1			0			42			50			2				105				150			6				7			1
1374		155		-410		0		0			1			0			42			2			50				105				6			150				7			1
1310		78		-410		0		0			1			0			2			50			50				6				150			150				7			1
1339		80		-480		0		0			1			0			21			50			2				75				150			6				7			1
1429		78		-410		0		0			1			0			2			50			50				6				150			150				7			1
1424		55		-480		0		0			1			0			5			50			2				15				150			6				7			1
1394		130		-480		0		0			1			0			15			15			2				45				45			6				7			1
1394		70		-480		0		0			1			0			10			8			15				30				24			45				14			1
1349		60		-380		0		0			1			0			5			5			5				15				15			15				18			1

//
1394		78		-335		0		0			1			0			42			50			2				105				150			6				7			1
1394		155		-410		0		0			1			0			42			2			50				105				6			150				7			1
1310		78		-410		0		0			1			0			2			50			50				6				150			150				7			1
1339		80		-480		0		0			1			0			21			50			2				75				150			6				7			1
1429		78		-410		0		0			1			0			2			50			50				6				150			150				7			1
1424		70		-480		0		0			1			0			5			50			2				15				150			6				7			1
1394		120		-480		0		0			1			0			15			15			2				45				45			6				7			1
1394		65		-480		0		0			1			0			10			8			15				30				24			45				14			1
1349		80		-380		0		0			1			0			5			5			5				15				15			15				18			1

//
674		78		-1295		0		0			1			0			42			50			2				105				150			6				7			1
674		155		-1370		0		0			1			0			42			2			50				105				6			150				7			1
610		78		-1370		0		0			1			0			2			50			50				6				150			150				7			1
639		80		-1440		0		0			1			0			21			50			2				75				150			6				7			1
729		78		-1370		0		0			1			0			2			50			50				6				150			150				7			1
724		55		-1440		0		0			1			0			5			50			2				15				150			6				7			1
694		130		-1440		0		0			1			0			15			15			2				45				45			6				7			1
694		70		-1440		0		0			1			0			10			8			15				30				24			45				14			1
649		60		-1340		0		0			1			0			5			5			5				15				15			15				18			1

634		78		-95			0		0			1			0			42			50			2				105				150			6				7			1
634		155		-170		0		0			1			0			42			2			50				105				6			150				7			1
570		78		-170		0		0			1			0			2			50			50				6				150			150				7			1
599		80		-240		0		0			1			0			21			50			2				75				150			6				7			1
689		78		-170		0		0			1			0			2			50			50				6				150			150				7			1
684		70		-240		0		0			1			0			5			50			2				15				150			6				7			1
654		120		-240		0		0			1			0			15			15			2				45				45			6				7			1
654		65		-240		0		0			1			0			10			8			15				30				24			45				14			1
609		80		-140		0		0			1			0			5			5			5				15				15			15				18			1

//-500 to z
//PosX,		PosY,   	PosZ,		Angle,	RotateX,	RotateY,	RotateZ,	ScaleX, 	ScaleY, 	ScaleZ,			OffsetX,    	OffsetY, 	OffsetZ,    	GeoType,  	Active

//Geotype 7 	= WALL
//Geotype 8 	= DOOR
//Geotype 9 	= BENCH
//Geotype 10	= TABLE
//Geotype 11	= TOILET
//Geotype 12	= CCTV
//Geotype 13	= DESK
//Geotype 14	= CELL_DOOR
//Geotype 15	= MIN_SEC_DOOR
//Geotype 16	= MED_SEC_DOOR
//Geotype 17	= MAX_SEC_DOOR
//Geotype 18	= BED
//Geotype 19	= STOOL
//Geotype 20	= MIN_SEC_KEY
//Geotype 21	= MED_SEC_KEY
//Geotype 22	= MAX_SEC_KEY
//Geotype 23	= INMATE_ARM
//Geotype 24	= INMATE_LEG
//Geotype 25	= INMATE_BODY
//Geotype 26	= INMATE_HEAD
//Geotype 27	= GUARD_ARM
//Geotype 28	= GUARD_LEG
//Geotype 29	= GUARD_BODY
//Geotype 30	= GUARD_HEAD
//Geotype 31	= WARDEN_ARM
//Geotype 32	= WARDEN_LEG
//Geotype 33	= WARDEN_BODY
//Geotype 34	= WARDEN_HEAD
//Geotype 35	= BATON
//Geotype 36	= CHAIR
//Geotype 37	= FLASHLIGHT
//Geotype 38	= CARROT
//Geotype 39	= CONTAINER
//Geotype 40	= DONUT
//Geotype 41	= ORANGE
//Geotype 42	= RICE
//Geotype 43	= FORK
//Geotype 44	= SPOON
//Geotype 45	= BOOK_1
//Geotype 46	= BOOK_2
//Geotype 47	= BOOKSHELF
//Geotype 48	= COMPUTER MONITOR 1
//Geotype 49	= COMPUTER MONITOR 2
//Geotype 50	= CUPBOARD 1
//Geotype 51	= CUPBOARD 2
//Geotype 52	= HANGING LIGHT
//Geotype 53	= PLYER
//Geotype 54	= POSTER 1
//Geotype 55	= POSTER 2
//Geotype 56	= RAILING
//Geotype 57	= REFRIGERATOR
//Geotype 58	= SCREWDRIVER
//Geotype 59	= TOILET
//Geotype 60	= WINDOW