1000		5		-1000		10		10		10		2	1	-1000		1000		2
1000		5		-1000		10		10		10		2	1	-1000		1000		2
1000		5		-1000		10		10		10		2	1	-1000		1000		2
1000		5		-1000		10		10		10		2	1	-1000		1000		2
1000		5		-1000		10		10		10		2	1	-1000		1000		2
1000		5		-1000		10		10		10		2	1	-1000		1000		2
1000		5		-1000		10		10		10		2	1	-1000		1000		2
1000		5		-1000		10		10		10		2	1	-1000		1000		2
1000		5		-1000		10		10		10		2	1	-1000		1000		2
-420		5		1040		10		10		10		2	1	-1000		1000		4
420		5		1040		10		10		10		2	1	-1000		1000		4
1000		5		-1000		10		10		10		2	1	-1000		-900		0
1000		5		-1000		10		10		10		2	1	1000		1000		0
1000		5		-1000		10		10		10		2	1	0		1000		0
1000		5		-1000		10		10		10		2	1	1000		0		0
-500		5		-710		10		10		10		2	1	-590		-720		1
-420		5		-710		10		10		10		2	1	0		-720		1
-120		5		-800		10		10		10		1	1	0		0		1
//PosX,		PosY,		PosZ,		ScaleX,		ScaleY,		ScaleZ,		Type,	Active,	DestinationX,	DestinationZ,	State



//STATE_PATROL, 0
//STATE_IDLE, 1
//STATE_WANDER, 2
//STATE_AVOID, 3
//STATE_CHASE 4
//NUM_STATE
	
