-306		68		145			0		0		0		1			42		50		2			105		150			6			7		1
-306		145		70			0		0		0		1			42		2		50			105		6			150			7		1
-370		68		70			0		0		0		1			2		50		50			6		150			150			7		1
-341		70		0			0		0		0		1			21		50		2			75		150			6			7		1
-251		68		70			0		0		0		1			2		50		50			6		150			150			7		1
-256		5		0			0		0		0		1			5		50		2			15		150			6			7		1
-286		120		0			0		0		0		1			15		15		2			45		45			6			7		1
-286		65		0			0		0		0		1			10		8		15			30		24			45			14		1
-331		50		100			0		0		0		1			5		5		5			15		15			15			18		1

-178		68		145			0		0		0		1			42		50		2			105		150			6			7		1
-178		145		70			0		0		0		1			42		2		50			105		6			150			7		1
-242		68		70			0		0		0		1			2		50		50			6		150			150			7		1
-213		70		0			0		0		0		1			21		50		2			75		150			6			7		1
-123		68		70			0		0		0		1			2		50		50			6		150			150			7		1
-128		5		0			0		0		0		1			5		50		2			15		150			6			7		1
-158		120		0			0		0		0		1			15		15		2			45		45			6			7		1
-158		65		0			0		0		0		1			10		8		15			30		24			45			14		1
-203		50		100			0		0		0		1			5		5		5			15		15			15			18		1

-50			68		145			0		0		0		1			42		50		2			105		150			6			7		1
-50			145		70			0		0		0		1			42		2		50			105		6			150			7		1
-114		68		70			0		0		0		1			2		50		50			6		150			150			7		1
-85			70		0			0		0		0		1			21		50		2			75		150			6			7		1
5			68		70			0		0		0		1			2		50		50			6		150			150			7		1
0			5		0			0		0		0		1			5		50		2			15		150			6			7		1
-30			120		0			0		0		0		1			15		15		2			45		45			6			7		1
-30			65		0			0		0		0		1			10		8		15			30		24			45			14		1
-75			50		100			0		0		0		1			5		5		5			15		15			15			18		1

78			68		145			0		0		0		1			42		50		2			105		150			6			7		1
78			145		70			0		0		0		1			42		2		50			105		6			150			7		1
14			68		70			0		0		0		1			2		50		50			6		150			150			7		1
43			70		0			0		0		0		1			21		50		2			75		150			6			7		1
133			68		70			0		0		0		1			2		50		50			6		150			150			7		1
128			5		0			0		0		0		1			5		50		2			15		150			6			7		1
98			120		0			0		0		0		1			15		15		2			45		45			6			7		1
98			65		0			0		0		0		1			10		8		15			30		24			45			14		1
53			50		100			0		0		0		1			5		5		5			15		15			15			18		1

206			68		145			0		0		0		1			42		50		2			105		150			6			7		1
206			145		70			0		0		0		1			42		2		50			105		6			150			7		1
142			68		70			0		0		0		1			2		50		50			6		150			150			7		1
171			70		0			0		0		0		1			21		50		2			75		150			6			7		1
259			68		70			0		0		0		1			2		50		50			6		150			150			7		1
256			5		0			0		0		0		1			5		50		2			15		150			6			7		1
226			120		0			0		0		0		1			15		15		2			45		45			6			7		1
226			65		0			0		0		0		1			10		8		15			30		24			45			14		1
181			50		100			0		0		0		1			5		5		5			15		15			15			18		1

206			68		401			0		0		0		1			42		50		2			105		150			6			7		1
206			145		326			0		0		0		1			42		2		50			105		6			150			7		1
142			68		326			0		0		0		1			2		50		50			6		150			150			7		1
171			70		256			0		0		0		1			21		50		2			75		150			6			7		1
259			68		326			0		0		0		1			2		50		50			6		150			150			7		1
256			5		256			0		0		0		1			5		50		2			15		150			6			7		1
226			120		256			0		0		0		1			15		15		2			45		45			6			7		1
226			65		256			0		0		0		1			10		8		15			30		24			45			14		1
181			50		356			0		0		0		1			5		5		5			15		15			15			18		1

334			68		401			0		0		0		1			42		50		2			105		150			6			7		1
334			145		326			0		0		0		1			42		2		50			105		6			150			7		1
270			68		326			0		0		0		1			2		50		50			6		150			150			7		1
299			70		256			0		0		0		1			21		50		2			75		150			6			7		1
387			68		326			0		0		0		1			2		50		50			6		150			150			7		1
384			5		256			0		0		0		1			5		50		2			15		150			6			7		1
354			120		256			0		0		0		1			15		15		2			45		45			6			7		1
354			65		256			0		0		0		1			10		8		15			30		24			45			14		1
309			50		356			0		0		0		1			5		5		5			15		15			15			18		1

462			68		401			0		0		0		1			42		50		2			105		150			6			7		1
462			145		326			0		0		0		1			42		2		50			105		6			150			7		1
398			68		326			0		0		0		1			2		50		50			6		150			150			7		1
427			70		256			0		0		0		1			21		50		2			75		150			6			7		1
515			68		326			0		0		0		1			2		50		50			6		150			150			7		1
512			5		256			0		0		0		1			5		50		2			15		150			6			7		1
482			120		256			0		0		0		1			15		15		2			45		45			6			7		1
482			65		256			0		0		0		1			10		8		15			10		8			15			14		1
437			50		356			0		0		0		1			5		5		5			5		5			5			18		1

206			68		-623		0		0		0		1			80		50		2			240			150			6			7		1
206			68		-387		0		0		0		1			80		50		2			240			150			6			7		1
325			68		-505		0		0		0		1			2		50		80			6			150			240			7		1
86			120		-452		0		0		0		1			2		15		15			6			45			45			7		1
208			145		-505		0		0		0		1			80		2		80			240			6			240			7		1
86			65		-452		0		0		0		1			8		10		15			24			30			45			15		1
86			68		-550		0		0		0		1			2		50		50			6			150			150			7		1
86			68		-410		0		0		0		1			2		50		15			6			150			45			7		1
172			48		-410		0		0		0		1			2		5		5			6			45			45			10		1
172			48		-442		0		0		0		1			5		5		5			45			45			45			19		1
-15			61		-121		0		0		0		1			5		5		5			0			0			0			23		1
-26			61		-121		0		0		0		1			5		5		5			0			0			0			23		1
-22			56		-120		0		0		0		1			5		5		5			0			0			0			24		1
-18.5		56		-120		0		0		0		1			5		5		5			0			0			0			24		1
-20.6		63		-120		0		0		0		1			5		5		5			0			0			0			25		1
-20.4		72		-120		0		0		0		1			5		5		5			0			0			0			26		1

13			61		-121		0		0		0		1			5		5		5			0			0			0			27		1
24			61		-121		0		0		0		1			5		5		5			0			0			0			27		1
21			56		-120		0		0		0		1			5		5		5			0			0			0			28		1
16.5		56		-120		0		0		0		1			5		5		5			0			0			0			28		1
19			63		-120		0		0		0		1			5		5		5			0			0			0			29		1
19			72		-120		0		0		0		1			5		5		5			0			0			0			30		1

-6			61			-121			0		0		1		0			5		5		5			0			0			0			31		1
5			61			-121			0		0		1		0			5		5		5			0			0			0			31		1
1			56			-120			0		0		1		0			5		5		5			0			0			0			32		1
-2.5		56			-120			0		0		1		0			5		5		5			0			0			0			32		1
-0.4		63.5		-120			0		0		1		0			5		5		5			0			0			0			33		1
-0.6		71.5		-120			0		0		1		0			5		5		5			0			0			0			34		1

-15			70		-150		0		0		0		1		5		5		5		0		0		0		35		1
-30			70		-150		0		0		0		1		5		5		5		0		0		0		36		1
-45			70		-150		0		0		0		1		5		5		5		0		0		0		37		1
-60			70		-150		0		0		0		1		5		5		5		0		0		0		38		1
-75			70		-150		0		0		0		1		5		5		5		0		0		0		39		1
-90			70		-150		0		0		0		1		5		5		5		0		0		0		40		1
-105		70		-150		0		0		0		1		5		5		5		0		0		0		41		1
-120		70		-150		0		0		0		1		5		5		5		0		0		0		42		1
-135		70		-150		0		0		0		1		5		5		5		0		0		0		43		1
-150		70		-150		0		0		0		1		5		5		5		0		0		0		44		1

-200		70		-150				0		0		1		0		5		5		5		0		0		0		45		1
-250		70		-150				0		0		1		0		5		5		5		0		0		0		46		1
-300		70		-150				0		0		1		0		5		5		5		0		0		0		47		1
-350 		70		-150				0		0		1		0		5		5		5		0		0		0		48		1
-400		70		-150				0		0		1		0		5		5		5		0		0		0		49		1
-450		70		-150				0		0		1		0		5		5		5		0		0		0		50		1
-500		70		-150				0		0		1		0		5		5		5		0		0		0		51		1
-550		70		-150				0		0		1		0		5		5		5		0		0		0		52		1
-600		70		-150				0		0		1		0		5		5		5		0		0		0		53		1
-650		70		-150				0		0		1		0		5		5		5		0		0		0		54		1
-700		70		-150				0		0		1		0		5		5		5		0		0		0		55		1
-750		70		-150				0		0		1		0		5		5		5		0		0		0		56		1
-800		70		-150				0		0		1		0		5		5		5		0		0		0		57		1
-850		70		-150				0		0		1		0		5		5		5		0		0		0		58		1
-900		70		-150				0		0		1		0		5		5		5		0		0		0		59		1
-950		70		-150				0		0		1		0		5		5		5		0		0		0		60		1
					

//PosX,		PosY,   	PosZ,		 Angle,		 RotateX,	RotateY,	RotateZ,	ScaleX, 	ScaleY, 	ScaleZ,			OffsetX,    	OffsetY, 	OffsetZ,    	GeoType,  	Active

//Geotype 7 	= WALL
//Geotype 8 	= DOOR
//Geotype 9 	= BENCH
//Geotype 10	= TABLE
//Geotype 11	= TOILET
//Geotype 12	= CCTV
//Geotype 13	= DESK
//Geotype 14	= CELL_DOOR
//Geotype 15	= MIN_SEC_DOOR
//Geotype 16	= MED_SEC_DOOR
//Geotype 17	= MAX_SEC_DOOR
//Geotype 18	= BED
//Geotype 19	= STOOL
//Geotype 20	= MIN_SEC_KEY
//Geotype 21	= MED_SEC_KEY
//Geotype 22	= MAX_SEC_KEY
//Geotype 23	= INMATE_ARM
//Geotype 24	= INMATE_LEG
//Geotype 25	= INMATE_BODY
//Geotype 26	= INMATE_HEAD
//Geotype 27	= GUARD_ARM
//Geotype 28	= GUARD_LEG
//Geotype 29	= GUARD_BODY
//Geotype 30	= GUARD_HEAD
//Geotype 31	= WARDEN_ARM
//Geotype 32	= WARDEN_LEG
//Geotype 33	= WARDEN_BODY
//Geotype 34	= WARDEN_HEAD
//Geotype 35	= BATON
//Geotype 36	= CHAIR
//Geotype 37	= FLASHLIGHT
//Geotype 38	= CARROT
//Geotype 39	= CONTAINER
//Geotype 40	= DONUT
//Geotype 41	= ORANGE
//Geotype 42	= RICE
//Geotype 43	= FORK
//Geotype 44	= SPOON
//Geotype 45	= BOOK_1
//Geotype 46	= BOOK_2
//Geotype 47	= BOOKSHELF
//Geotype 48	= COMPUTER MONITOR 1
//Geotype 49	= COMPUTER MONITOR 2
//Geotype 50	= CUPBOARD 1
//Geotype 51	= CUPBOARD 2
//Geotype 52	= HANGING LIGHT
//Geotype 53	= PLYER
//Geotype 54	= POSTER 1
//Geotype 55	= POSTER 2
//Geotype 56	= RAILING
//Geotype 57	= REFRIGERATOR
//Geotype 58	= SCREWDRIVER
//Geotype 59	= TOILET
//Geotype 60	= WINDOW

//PRISON DIMENSIONS - 128 (X) X 160 (Z)