500			5			0			10			10			10			2		1		600				100				2
400			5			-100		10			10			10			2		1		600				100				2		
400			5			-200		10			10			10			2		1		600				100				2
400			5			-300		10			10			10			2		1		600				100				2
400			5			-100		10			10			10			2		1		600				100				2
400			5			200			10			10			10			2		1		600				100				2
400			5			100			10			10			10			2		1		600				100				2
400			5			300			10			10			10			2		1		600				100				2
400			5			400			10			10			10			2		1		600				100				2
400			5			-50			10			10			10			2		1		600				100				2
400			5			-450		10			10			10			2		1		600				100				2
400			5			-350		10			10			10			2		1		600				100				2
400			5			-250		10			10			10			2		1		600				100				2
400			5			-600		10			10			10			2		1		600				100				2
400			5			-500		10			10			10			2		1		600				100				2
400			5			-400		10			10			10			2		1		600				100				2

400			5			-1100		10			10			10			2		1		600				-1000			2
400			5			-1000		10			10			10			2		1		600				-1000			2
400			5			-1200		10			10			10			2		1		600				-1000			2
400			5			-1300		10			10			10			2		1		600				-1000			2
400			5			-1400		10			10			10			2		1		600				-1000			2
400			5			-1500		10			10			10			2		1		600				-1000			2
400			5			-1600		10			10			10			2		1		600				-1000			2
400			5			-1700		10			10			10			2		1		600				-1000			2
600			5			-1650		10			10			10			2		1		600				-1000			2
700			5			-1600		10			10			10			2		1		600				-1000			2
200			5			-1600		10			10			10			2		1		600				-1000			2

0			5			1400		10			10			10			2		1		600				1300			2
0			5			1400		10			10			10			2		1		600				1300			2
0			5			1400		10			10			10			2		1		600				1300			2
0			5			1400		10			10			10			2		1		600				1300			2
0			5			1400		10			10			10			2		1		600				1300			2
0			5			1400		10			10			10			2		1		600				1300			2
0			5			1400		10			10			10			2		1		600				1300			2
0			5			1400		10			10			10			2		1		600				1300			2
0			5			1400		10			10			10			2		1		600				1300			2
0			5			1400		10			10			10			2		1		600				1300			2
0			5			1400		10			10			10			2		1		600				1300			2

//PosX,		PosY,		PosZ,		ScaleX,		ScaleY,		ScaleZ,		Type,	Active,	DestinationX,	DestinationZ,	State



//STATE_PATROL, 0
//STATE_IDLE, 1
//STATE_WANDER, 2
//STATE_AVOID, 3
//STATE_CHASE 4
//NUM_STATE

// Type
// 1 - Warden
// 2 - Guard
	
